Esdras	Torres
Paula	Ibáñez
Nieves	Rubio
Carmen	Sánchez
Ignacio	Fernández
Benigno	Peña
Casio	Santana
Atanasio	Pastor
Alicia	Ortiz
Lourdes	Ruiz
Alipio	Herrera
Blanca	López
Virgilio Molina
Josué	Muñoz
Marcial	Soler
Jonás	Carrasco
Mónica	Vázquez
Cleofás	Velasco
Enrique	Hernández
Josefina	Vidal
Vicente	Carmona
Esteban	Domínguez
Homero	Vega
Felipe	Lozano
Simón	Fuentes
Gonzalo	Cabrera
César	Cambil
Celia	Román
Norberto	Gómez
Lucas	Nieto
Cayetano	Rey
Juana	Martínez
Román	Bravo
Heliodoro	Serrano
Leoncio	Jiménez
Míriam	Blanco
Ladislao	Aguilar
Probo	Crespo
Gema	Moya
Óscar	García
Constancio	Gallego
Eulalia	Campos
Wilfredo	Ramírez
Balduino	Iglesias
Elisa	Pérez
Clara	Vargas
Hilarión	Santos
Andrea	Ramos
Primo	Moreno
Ceferino	Arias
Fidel	Sáez
Beatriz	Medina
Isaías	Caballero
Antonio	Cortés
Ángela	Cruz
Adela	Guerrero
Oscar	González
Aniano	Navarro
Milagros	Montero
Dámaso	Gallardo
Pascual	Esteban
Maximiliano	León
Fátima	Gil
Liduvina	Calvo
Ifigenia	Herrero
Ariadna	Díez
Jerónimo	Santiago
Sara	Díaz
Laura	Benítez
Inmaculada	Lorenzo
Isidro	Morales
Javier	Alonso
Yolanda	Vicente
Adrián	Montoro
Federico	Castro
Octavio	Pascual
Cesáreo	Ferrer
Daciano	Martín
Aurora	Prieto
Anastasia	Garrido
Nuria	Márquez
Oriol	Gutiérrez
Daniel	Blesa
Colombo	Parra
Salomón	Soto
Heraclio	Ortega
Velerio	Méndez
Ana	Rodríguez
Abel	Mora
Luciano	Suárez
Alfredo	Cano
Julio	Delgado
Amadeo	Hidalgo
Iván	Romero
Encarnación	Giménez
Eva	Castillo
Domingo	Núñez
Efrén	Álvarez
Lino	Marín
Guadalupe	Flores
Bella  	Henry
Josef  	Fuentes
Lahoma  	Case
Karly  	Moran
Karolyn  	Wilkerson
Arvilla  	Hines
Delphia   	Morris
Rae  	Porter
Lenita  	Page
Shameka  	Giles
Georgine  	Martin
Delores  	Brooks
Sheryll  	Delgado
Shay  	Drake
Quincy  	Parks
Perry  	Fry
Frankie  	Whitney
Veola  	Rivers
Gino  	Flores
Rhona  	Logan
Lucila  	Nicholson
Tennille  	Gay
Daniel  	Davies
Phillis  	Rollins
Milagro  	Beck
Cindi  	Gregory
Kattie  	Jordan
Shondra  	Murphy
Kermit  	Chang
Jerold  	Melton
Kitty  	Choi
Antonia  	Best
Bettie  	Parsons
Romaine  	Petersen
Beaulah  	Taylor
Allene  	Rosario
Sage  	Thompson
Tawana  	Foley
Walter  	Osborn
Mallory  	Rice
Sallie  	Parrish
Maude  	Bentley
Norman  	Robles
Zada  	Padilla
Ema  	Daniel
Errol  	Mcgrath
Marhta  	Harmon
Juliann  	Swanson
Claretha  	Donovan
Rubie  	Quinn
Marybelle  	Dorsey
Joni  	Nunez
Candance  	Fernandez
Diedra  	Barnes
Peg  	Green
Wendy  	Knox
Evette  	Booker
Parthenia  	Phelps
Silvia  	Webster
Zora  	Molina
Sharda  	Liang 
Vivien  	Rong
Loreen  	Xia 
Merri  	Su
Jacki  	Qiao 
Vasiliki  	Huo
Alysa  	Zeng 
Karine  	Zhihao
Kristel  	Long 
Meaghan  	Ruogang
Lucretia  	Yao 
Syble  	Yimu
Roxane  	Lei 
Johnette  	Jing
Tanesha  	Feng 
Donnette  	Hanying
Elouise  	Cheng 
Nelda  	Liu
Nieves  	Jin
Lesli  	Arias
Siobhan  	Arocas Pasadas
Judy  	Viso Gilabert
Twanda  	Ayala Ferreras
Saturnina  	Baez Tejado
Samantha  	Bastardes Soto
Lina  	Anguera Vilafranca
Suanne  	Pascual Aloy
Agueda  	Vallés Girvent
Detra  	Raya Garcia
Myrtie  	Andreu Cruz
Jenine  	Baraldés Comas
Elanor  	Berengueras Cullerés
Linsey  	López De Pablo Garcia Uceda
Shemeka  	Arnau Moreno
Leisa  	Raya Gavilan
Tempie  	Zambudio Figuls
Lajuana  	Bidault Cullerés
Tereasa  	Biosca Fontanet
Danyell  	Zafra Figuls
Valentina	Aleu Icart
Estefania	Badia Torné
Queralt	Morales Gese
Joan	Blanco Fontanet
Joan	Alvarez Fernández
Marc	Garcia Almoguera
Josep	Libori Figueras
Esther	Bidault Pueyo
Laura	Benitez Jose
Raquel	Pascual Flores
Joan	Ayala Torné
Maria Isabel	Listan Figueras
Adrià	Rasero Gavilan
Gerard	Arnalot Puig
Eliot	Moliner Garrido
Jordi	Galobart Garcia
Lluís	López Garrigassait
Laura	Sánchez Gómez
Jordi	Alavedra Sunyé
Dounya	Aligué Bonvehí
Julio	Mas Franch
Andreu	Aloy Compte
Ramon	Asensio Vega
David-Jese	Bidault Pérez
Aran	Aloy Codinachs
Gemma	Altimiras Armenteros
Ivan	Belmonte Sánchez
David	Bajona Garcia
Xavier	Aguilar Rodriguez
Mario	Barriga Soto
Jesus	Avila Masjuan
Gemma	Parramon Flores
Silvia	Aguilar Ramos
Albert	Ayala Alsina
Maria	Alvarez Troyano
Berta	Alins González
Berta	Acuña Tort
Mireia	Algué Trancho
Gemma	Badia Castillo
Maria Isabel	Benitez Flores
Toni	Torruella Garcia
Alejandro	Alberich Rodriguez
Joan Martí	Armencot Puig
Ingrid	Aligué Rivera
Oliver	Barriga Riu
Sandra	Portella Gispets
Jordi	Aguilera Baena
Marc	Rodriguez García
Jordina	Aguilar Sunyé
Maria José	Barriga Tardà
Raquel	Barcons Lara
